0000111110000000000
0000100010000000000
0000120010000000000
0011100011000000000
0010020201000000000
1110101101000111111
1000101101111100441
1020020000000020441
1111101110151100441
0000100000111111111
0000111111100000000