0000000000000000000
0000000011111100000
0000000010000100000
0000000112100100000
0000000144220100000
0000001114101100000
0000001025201000000
0000001014101000000
0000001000001000000
0000001111111000000
0000000000000000000