0000000000000000000
0000000000000000000
0111111111111111110
0100000042000000010
0101111121111111010
0101000205020201010
0101020444440001010
0101111141211111010
0100000000000000010
0111111111111111110
0000000000000000000