0000000000000000000
0000001111111100000
0000001001000100000
0000001042420100000
0000001024240100000
0000001142420100000
0000001024240100000
0000001005100100000
0000001111111100000
0000000000000000000
0000000000000000000